Communications Commands â€” Commands must be entered in the exact format shown. Do not
send a [LF] (line feed) after the [CR] (character return). Be sure to follow character case exactly.
A response followed by an exclamation point (!) indicates that a command was executed correctly. A
question mark (?) indicates that the Controller could not execute the command (either because it
was in an improper format or the values were outside the allowable range). A response must be
received from the Controller before another command can be sent. All responses are terminated
with a single [CR].


GENERAL COMMANDS (Digital & Programmable Controllers)
Command Name	Command String	Parameters	Return Message
Set Command Echo	SEi[CR]	i=1 (Echo ON), i=0 (Echo OFF)	![CR]
Set Local Lockout	SAi[CR]	i=1 (Locked), i=0 (Unlocked)	![CR]
Set Setpoint	SSxxx.xx[CR]	xxx.xx = temperature value	![CR]
Set On/Off	SOi[CR]	i=1 (On), i=0 (Off)	![CR]
Set Power Status	SWi[CR]	i=1 (Set), i=0 (Reset)	![CR]
Set Pump Speed	SMx[CR]	x = 0 to 70	![CR]
Set High Alarm	SHxxx.xx[CR]	xxx.xx = temperature	![CR]
Set Low Alarm	SLxxx.xx[CR]	xxx.xx = temperature	![CR]
Set Remote Probe	Sri[CR]	i=0 (Internal), i=1 (External)	![CR]
Get Setpoint Temperature	RS[CR]	None	![CR]
Get Internal Temperature	RT[CR]	None	![CR]
Get External Temperature	RR[CR]	None	![CR]
Get Local Lockout Status	RA[CR]	None	0[CR] or 1[CR]
Get Power Status	RW[CR]	None	x[CR] (0 or 1)
Get Pump Speed	RM[CR]	None	x[CR] (0â€“70)
Get Temperature Units	RU[CR]	None	C[CR] or F[CR]
Get High Alarm	RH[CR]	None	xxx.xx[CR]
Get Low Alarm	RL[CR]	None	xxx.xx[CR]
Get Alarm Status	RF[CR]	None	0[CR] (No alarm) or 1[CR] (Alarm)
Get Operation Status	RO[CR]	None	1[CR] (Running) or 0[CR] (Standby)
Get Firmware Revision	RB[CR]	None	00XXXXXXXX[CR]

ðŸ”„ PROGRAMMABLE-CONTROLLER-ONLY COMMANDS

Command Name	Command String	Parameters	Return Message
Set Program Number	SVx[CR]	x = program number (1â€“10)	![CR]
Set Program Steps	Ssxx[CR]	xx = number of steps (1â€“50)	![CR]
Set Program Last Loop Number	SKxx[CR]	xx = loop count (1â€“99)	![CR]
Set Program Step Setpoint	SYn,xxx.xx[CR]	n = step number, xxx.xx = temperature	![CR]
Set Program Step Period	SXn,xxx.xx[CR]	n = step number, xxx.xx = time in minutes/seconds	![CR]
Set Program Run Status	SGi[CR]	i=1 (Run), i=0 (Pause)	![CR]
Set Program Stop	SR[CR]	None	![CR]
Set Program Skip Period	SJ[CR]	None	![CR]
Get Program Number	RV[CR]	None	x[CR] (program number)
Get Program Steps	Rs[CR]	None	x[CR] (step count)
Get Program Loops	RK[CR]	None	xx[CR] (loop count)
Get Program Loop Number	RI[CR]	None	xx[CR] (current loop)
Get Program Setpoint Step	RYn[CR]	n = step number	xxx.xx[CR]
Get Program Set Period	RXn[CR]	n = step number	xxx.xx[CR]
Get Program Step Number	RC[CR]	None	xx[CR] (current step)
Get Program Elapsed Step Time	RE[CR]	None	xxx.xx[CR]
Get Program Status	RG[CR]	None	0[CR] (Stopped), 1[CR] (Running), 2[CR] (Paused)